F 220,100,0
C 70,70,120
NO ./textures/north.xpm
SO ./textures/south.xpm
WE ./textures/west.xpm
EA ./textures/east.xpm
111111
1N0001
101101
100001
111111