NO ./textures/north.xpm
SO ./textures/south.xpm
      
               




F            80,80,80
              WE              ./textures/west.xpm
EA ./textures/east.xpm


C 30,60,100

11111111111111
1N000000011111
1111111101
       1001
       101111
       1000001
        1000001
111111111111111