NO ./textures/north.xpm
SO ./textures/south.xpm
WE ./textures/west.xpm
EA ./textures/east.xpm
F 100,90,80
C 20,40,80

11111111111111111111111111111111
10000000000000000000000000000001
100000000000000000000000000000S1
10000000000000000000000000000001
11111111111111111111111111111111
