NO ./textures/north.xpm
SO ./textures/south.xpm
WE ./textures/west.xpm
EA ./textures/east.xpm

F 100,90,80
C 20,40,80

11111111
10000001
100S0001
10000001
11111111
