NO ./textures/north.xpm
SO ./textures/south.xpm
          F 100,90,80


WE      ./textures/west.xpm
EA ./textures/east.xpm


C 20,40,80



                    11111
                   100S001
                   1000001
           11111111100000111111111
          1000000000000000000000001
          1000000000000000000000001
          1000000000000000000000001
          1000000000000000000000001
           11111111110001111111111
                   1000001
                   1000001
                   1000001   1111111111111111111111
 1111111111111111111000001  110000000000000000000011
10000000000000000000000001  100000000011110000000001
10000000000000000000000001   1100000011111100000011
1000111111111111111111111   100000000011110000000001
10001                       110000000000000000000011
 101                         1111111110000111111111
 101                                 100001
 101                                 100001
 101111111111111111111111111111111111100001
 100000000000000000000000000000000000000001
 100000000000000000000000000000000000000001
 100000000000000000000000000000000000000001
 10111111111111111111111111111111111111111
 101
 101             111111111111     111111111111111
 101            1000000000000111110000000000000001
 101         11110000000000001000000000000000000001
 101        1000000000000000010000000000011100000001
 101        10000000000000000100010000000100000000001    111111
 101111111110000000000110000000011100000010000000000011110000001
 100000000000000000000110000000111110000011111000000000000000001
  11111111110000000111111100000000111000000001000000011110000001
            10000001111111000000000100000000010000001    111111
            1000000000000000000000000000000001000001
             11110000000000010000000000000000000001
                1000000000001111100000000000000001
                 11111111111     1111111111111111