NO ./textures/north.xpm
SO ./textures/south.xpm
WE ./textures/west.xpm
EA ./textures/east.xpm

F 300,400,500
C 30,60,100

11111111111111
1N000000011111
1111111101   1
1        01  1
1  0000  01111
1  0110  000001
1  0000       1
11111111111111
